2 10 15

...............
...............
....oo.........
....1o.........
..oooooo.......
..o.....ooo....
..o............
ooo............
...............
...............

...............
...............
....oo.........
.....o.........
..oooo.........
ooo............
..o............
..o.o..........
ooooo..........
2..............